WWWWWWWWWWWWWWWWWWWWWWW
W---------------------W
W-------P-------------W
W--------------S------W
W---E-----------------W
WWWWWWWWWWWWWWWWWWWWWWW